40 40
OOOOOOOOOOOOOOOOOOOOOOOOOOOOOOOOOOOOOOOO
OOOOOOOOXXXXXOOOOOOOOOOOOOOOOOOOOOOOOOOO
OOOOOOOOXOOOXOOOOOOOOOOOOOOOOOOOOOOOOOOO
OOOOOOOOXOOOXOOOOOOOOOOOOOOOOOOOOOOOOOOO
OOOOOOOOXOOOXOOOOOOOOOOXXXXXOOOOOOOOOOOO
OOOOOOOOXXXXXOOOOOOOOOOXXXXXOOOOOOOOOOOO
OOOOOOOOOOOOOOOOOOOOOOOXXXXXOOOOOOOOOOOO
OOOOOOOOOOOOOOOXOOOOOOOXXXXXOOOOOOOOOOOO
OOOOOOOOOOOOOOXXOOOOOOOXXXXXOOOOOOOOOOOO
OOOOOOOOOOOOOXXXOOOOOOOOOOOOOOOOOOOOOOOO
OOOOOOOOOOOOXXXXOOOOOOOOOOOOOOOOOOOOOOOO
OOOOOOOOOOOXXXXXOOOOOOOOOOOOOOOOOOOOOOOO
OOOOOOOOOOXXXXXXOOOOOOOOOOOOOOOOOOOOOOOO
OOOOOOOOOXXXXXXXOOOOOOOOOOOOOOOOOOOOOOOO
OOOOOOOOXXXXXXXXOOOOOOOOOOOOOOOOOOOOOOOO
OOOOOOOXXXXXXXXXOOOOOOOOOOOOOOOOOOOOOOOO
OOOOOOXXXXXXXXXXOOOOOOOOOOOOOOOOOOOOOOOO
OOOOOXXXXXXXXXXXOOOOOOOOOOOOOOOOOOOOOOOO
OOOOXXXXXXXXXXXXOOOOOOOOOOOOOOOOOOOOOOOO
OOOXXXXXXXXXXXXXOOOOOOOOOOOOOOOOOOOOOOOO
OOXXXXXXXXXXXXXXOOOOOOOOOOOOOOOOOOOOOOOO
OOOXXXXXXXXXXXXXOOOOOOOOOOOOOOOOOOOOOOOO
OOOOXXXXXXXXXXXXOOOOOOOOOOOOOOOOOOOOOOOO
OOOOOXXXXXXXXXXXOOOOOOOOOOOOOOOOOOOOOOOO
OOOOOOXXXXXXXXXXOOOOOOOOOOOXXXXXOOOOOOOO
OOOOOOOXXXXXXXXXOOOOOOOOOOOXOOOXOOOOOOOO
OOOOOOOOXXXXXXXXOOOOOOOOOOOXOOOXOOOOOOOO
OOOOOOOOOXXXXXXXOOOOOOOOOOOXOOOXOOOOOOOO
OOOOOOOOOOXXXXXXOOOOOOOOOOOXXXXXOOOOOOOO
OOOOOOOOOOOXXXXXOOOOOOOOOOOOOOOOOOOOOOOO
OOOOOOOOOOOOXXXXOOOOOOOOOOOOOOOOOOOOOOOO
OOOOOOOOOOOOOXXXOOOOOOOOOOOOOOOOOOOOOOOO
OOOOOOOOOOOOOOXXOOOOOOOOOOOOOOOOOOOOOOOO
OOOOOOOOOOOOOOOXOOOOOOOOOOOOOOOOOOOOOOOO
OOOOOOOOOOOOOOOOOOOOOOOOOOOOOOOOOOOOOOOO
OOOOOOOOOOOOOOOOOOOOOOOOOOOOOOOXXXXXOOOO
OOOOOOOOOOOOOOOOOOOOOOOOOOOOOOOXXXXXOOOO
OOOOOOOOOOOOOOOOOOOOOOOOOOOOOOOXXXXXOOOO
OOOOOOOOOOOOOOOOOOOOOOOOOOOOOOOXXXXXOOOO
OOOOOOOOOOOOOOOOOOOOOOOOOOOOOOOXXXXXOOOO
