40 40
OOOOOOOOOOOOOOOOOOOOOOOOOOOOOOOOOOOOOOOO
OOOOOOOOOOOOOOOOOOOOOOOOOOOOOOOOOOOOOOOO
OOOOOOOOXXXXXOOOOOOOOOOOOOOOOOOOOOOOOOOO
OOOOOOOOXXXXXOOOOOOOOOOOOOOOOOOOOOOOOOOO
OOOOOOOOXXXXXOOOOOOOOOOOOOOOOOOOOOOOOOOO
OOOOOOOOOOOOOOOOOOOOOOOOOOOOOOOOOOOOOOOO
OOOOOOOOOOOOOOOOOOOOOOOXXXXXOOOOOOOOOOOO
OOOOOOOOOOOOOOOXOOOOOOOXXXXXOOOOOOOOOOOO
OOOOOOOOOOOOOOXXOOOOOOOXXXXXOOOOOOOOOOOO
OOOOOOOOOOOOOXXXOOOOOOOOOOOOOOOOOOOOOOOO
OOOOOOOOOOOOXXXXOOOOOOOOOOOOOOOOOOOOOOOO
OOOOOOOOOOOXXXXXOOOOOOOOOOOOOOOOOOOOOOOO
OOOOOOOOOOXXXXXXOOOOOOOOOOOOOOOOOOOOOOOO
OOOOOOOOOXXXXXXXOOOOOOOOOOOOOOOOOOOOOOOO
OOOOOOOOXXXXXXXXOOOOOOOOOOOOOOOOOOOOOOOO
OOOOOOOXXXXXXXXXOOOOOOOOOOOOOOOOOOOOOOOO
OOOOOOXXXXXXXXXXOOOOOOOOOOOOOOOOOOOOOOOO
OOOOOXXXXXXXXXXXOOOOOOOOOOOOOOOOOOOOOOOO
OOOOXXXXXXXXXXXXOOOOOOOOOOOOOOOOOOOOOOOO
OOOXXXXXXXXXXXXXOOOOOOOOOOOOOOOOOOOOOOOO
OOXXXXXXXXXXXXXXOOOOOOOOOOOOOOOOOOOOOOOO
OOOXXXXXXXXXXXXXOOOOOOOOOOOOOOOOOOOOOOOO
OOOOXXXXXXXXXXXXOOOOOOOOOOOOOOOOOOOOOOOO
OOOOOXXXXXXXXXXXOOOOOOOOOOOOOOOOOOOOOOOO
OOOOOOXXXXXXXXXXOOOOOOOOOOOOOOOOOOOOOOOO
OOOOOOOXXXXXXXXXOOOOOOOOOOOXXXXXOOOOOOOO
OOOOOOOOXXXXXXXXOOOOOOOOOOOXXXXXOOOOOOOO
OOOOOOOOOXXXXXXXOOOOOOOOOOOXXXXXOOOOOOOO
OOOOOOOOOOXXXXXXOOOOOOOOOOOXXXXXOOOOOOOO
OOOOOOOOOOOXXXXXOOOOOOOOOOOXXXXXOOOOOOOO
OOOOOOOOOOOOXXXXOOOOOOOOOOOXXXXXOOOOOOOO
OOOOOOOOOOOOOXXXOOOOOOOOOOOXXXXXOOOOOOOO
OOOOOOOOOOOOOOXXOOOOOOOOOOXXXXXOOOOOOOOO
OOOOOOOOOOOOOOOXOOOOOOOOOXXXXXOOOOOOOOOO
OOOOOOOOOOOOOOOOOOOOOOOOXXXXXOOOOOOOOOOO
OOOOOOOOOOOOOOOOOOOOOOOXXXXXOOOOOOOOOOOO
OOOOOOOOOOOOOOOOOOOOOOXXXXXOOOOOOOOOOOOO
OOOOOOOOOOOOOOOOOOOOOXXXXXOOOOOOOOOOOOOO
OOOOOOOOOOOOOOOOOOOOXXXXXOOOOOOOOOOOOOOO
OOOOOOOOOOOOOOOOOOOXXXXXOOOOOOOOOOOOOOOO
